WWWWWWWWWWWW
W  W6W   WFW
W WWaW  WWfW
W W 3 bb   W
W WWWWWWW2WW
W W4 a     W
W WWW      W
W W     WWWW
W1W    W   W
W WWWWaWWWWW
W a    c  1W
WWWWWWWWWWWW