WWWWWWWWWWWW
W         6W
WWWWW      W
WWWf1WWWW  W
WWWWff   fWW
W   f      W
WWW WWWWWWbW
W2  W      W
WWWWWWWW WWW
WabacaFWaWWW
Wfdafcdf 64W
WWWWWWWWWWWW