WWWWWWWWWWWW
W    12345 W
WaWWWWWWWWfW
W       WWfW
WWWWW    aaW
W    WWWbWfW
W  W     ccW
WcW WWWWWWfW
W        ddW
WWWWWWWWdWfW
W6 e     WFW
WWWWWWWWWWWW