WWWWWWWWWWWW
W          W
WWWWW  WWWWW
WFefe      W
WWWWWWWWW  W
W          W
WWWWW  WWWWW
WFbc      WW
WWWWWWWWW  W
W3ef       W
W2fe   W 56W
WWWWWWWWWWWW