WWWWWWWWWWWW
W  6f     5W
WWWWWWWWWWeW
W4  e      W
W WWWWWWWdWW
W  1f     3W
WcWWWWWWWcWW
W2  c      W
WaWWWWWWWbWW
WWWWW   b  W
WF  a   WWWW
WWWWWWWWWWWW