WWWWWWWWWWWW
W     1W dFW
WWWaWWW4W dW
W        ccW
WeefWW     W
W    4W   WW
W     W  d3W
WWWW2WW WWWW
W  6f  6WWWW
WffWWWW    W
WFf   5fWWWW
WWWWWWWWWWWW