WWWWWWWWWWWW
W       6WFW
WWWWfWWWWW W
W       4WaW
WWWWdWWWWWbW
W       1WcW
WWWWaWWWWWdW
W       3WeW
WWWcWWWWWWfW
W       W  W
W 123456   W
WWWWWWWWWWWW