WWWWWWWWWWWW
W    1W2W3WW
W     WaWbWW
WWW       WW
W 1c       W
WaWWWWWWWWcW
W 3 c   5  W
WWWWW cWWWWW
W6   be 2  W
WWfWWWWWWaWW
W         FW
WWWWWWWWWWWW