WWWWWWWWWWWW
W   W4a   4W
WWW6f w    W
WF WWW afdaW
WWfW262W   W
W  W WW3WaWW
WWcW WaWbW W
WW       WWW
W1bWW  W   W
WWW  WW  WbW
W63a  e W5 W
WWWWWWWWWWWW