WWWWWWWWWWWW
W    W  aaaW
WWWW W WWaWW
W1W   ab4  W
W   e  eeddW
Wccce2a WWWW
W 3Wffd   aW
W Wff aWW6WW
Wdd   WWW4WW
WWWcc1a6f WW
W1  W  aWaFW
WWWWWWWWWWWW