WWWWWWWWWWWW
W    W  c66W
WW     WWWWW
W      W3  W
W  W    WWaW
WW 1W      W
WWWWWaWWWW W
W3f  f f2W5W
Wf  f1f fW W
WfWWWWWWWWdW
Wc b a f4WFW
WWWWWWWWWWWW