WWWWWWWWWWWW
W   3   d 6W
WWW    WWWWW
W6c    W  4W
WWW     ffWW
W3WWWWdWWWWW
Wc   6   c3W
W    W    fW
W   WWWW   W
WfWWWWWWW aW
Wcf c1 W WFW
WWWWWWWWWWWW