WWWWWWWWWWWW
W   1216123W
W          W
W   3456426W
W WWWWWWWWWW
Wbacf   WffW
WefdW  WbWfW
WbcfaW  WcWW
WWdabWWfcWfW
WaWWfebWfaWW
WWccWcafdcFW
WWWWWWWWWWWW