WWWWWWWWWWWW
W  1 a2 W 4W
WWWWWWWbWbWW
WFfaWWW   1W
WeWa   WdWWW
WfWfWWfW 6WW
W 6aaW 1W WW
WcW5 W W  3W
WaWW WdWWaWW
W W fW a  WW
W f   a6af4W 
WWWWWWWWWWWW