WWWWWWWWWWWW
W   f      W
W   W cWWWaW
W12  WFec  W
W3   WWWWWfW
Wa aWFeb acW
Wbac W6bba W
Wd5b  WWWdWW
WWeWW  c  fW
W1  2WWW 4bW
W134 3c3WWFW
WWWWWWWWWWWW