WWWWWWWWWWWW
W   f      W
W   W cWWWaW
W1   WFec  W
W34  WWWWWfW
Wa aWFeb acW
Wbac W6bba W
Wd5b  WWWdWW
WWeWW  c  fW
W1  2WWW 4fW
W134 3c3WWFW
WWWWWWWWWWWW