WWWWWWWWWWWW
W   1216123W
W  WWWWWW  W
W W345641W W
W   ebabaW W
W WcabefaW W
W WdeffaeW W
W WaceddaW W
W WabcefFW W
WffWWWWWWffW
W fWWFWWWf W
WWWWWWWWWWWW