WWWWWWWWWWWW
W W       3W
W  e       W
W WW   WWWcW
W  5WWW1   W
WeWWFWFWWWaW
W   dWc    W
W  5W4W2   W
WfWW e WWWbW
W   W5W    W
W    b     W
WWWWWWWWWWWW