WWWWWWWWWWWW
W   W4W1W5WW
W6WWWfWdWaWW
W          W
W  WabdeW  W
WaWWWWWWWWeW
W3c b52c b2W
WWWWWeeWWWWW
W1b      a6W
WWWWa  bWWWW
WFf  WW  fFW
WWWWWWWWWWWW